NO ./maps/NORTH.xpm

SO ./maps/SOUTH.xpm

F           123          ,         123         ,         123

WE         ./maps/WEST.xpm            

EA ./maps/EAST.xpm

                        

C 24,130,123


                  

       1111111111111111
   11111000000000000001
   100000000W0000000001
   11111000000000000001111111
     1111111110000000000000011111111
             11111111000001110011101
                    1000000000000001
                    1000000001111101
                    1000000000000101
                    1111111111111111
