NO ./maps/NORTH.xpm

SO ./maps/SOUTH.xpm

WE ./maps/WEST.xpm

EA ./maps/EAST.xpm

F 123,123,0

C 224,130,123

1111111111111111111

        1111111111111111111111111
        1000000000110000000000001
        1011000001110000010000001
        1001000000000000110000001
111111111011000001110000110000001
111111111011000001110000110000001
111101111111110111000000100011111
11110111111111011101010010001
11000000110101011111111110001111
100000000000000011  110010001
10000000000000001     1010001
11000001111111111  1111111101
11110111  110101   1111010W01
11111111  111111   1111111111
