
NO ./maps/NORTH.xpm

SO ./maps/SOUTH.xpm


F 123,123,0
WE ./maps/WEST.xpm
EA ./maps/EAST.xpm


C 224,130,123

1111111111111111
1000000000000001
1000000000000001
1000000000000001
1000000000000001
1000001110011101
1000000000W00001
1000000001111101
1000000000000101
1111111111111111