NO ./path_to_the_north_texture

SO ./path_to_the_south_texture

WE ./path_to_the_west_texture

EA ./path_to_the_east_texture

F 220,110,1

C 224,130,123


        1111111111111111111111111
        1000000000110000000000001
        101100000111000W000000001
        1001000000000000000000001
1111111110110000011100000N0000001
111111111011000001110000000000001
111101111111110111000000100011111
11110111111111011101010010001
11000000110101011111111111111111111111
100000000000000011  110010001
10000000000000001     1010001
11000001111111111  11111110011
11110111 1110101   1111010001
11111111 1111111 111111111111
