
NO ./maps/NORTH.xpm

SO ./maps/SOUTH.xpm

WE ./maps/WEST.xpm

EA ./maps/EAST.xpm

F 123,123,0

C 224,130,123

1111111111111111
1000000000000001
1000000000000001
1000000000000001
1000000000000001
1000000011110001
1000000000W00001
1000000011110001
1000000000000001
1111111111111111