
NO ./maps/NORTH.xpm

SO ./maps/SOUTH.xpm

WE ./maps/WEST.xpm

EA ./maps/EAST.xpm

F 123,123,0

C 224,130,123

1111111111111111
1000000000000001
1000000000000001
1000001111110001
1000000000000001
1000001111111101
1000000001W10001
1000000000111101
1000000000000101
1111111111111111